71
12
32 4  0  0  0  0  0  0  0  0  0  0  0  0  0  0  0  0  0  0  0  0  0  0  0  0  0  0  0  0  0  0  0  0  0  0  0  0  0 0 0 0 0 0 0 0 0 0 0 0 0 0 0 0 0 0 0 0 0 0 0 0 0 0 0 0 0 0 0 0 0 0
36 37 0  0  0  0  0  0  0  0  0  0  0  0  0  0  0  0  0  0  0  0  0  0  0  0  0  0  0  0  0  0  0  0  0  0  0  0  0   0 0  0  0  0  0  0 0  0 0 0  0 0 0  0 0 0  0 0 5  0 0 0 0 0 0 0 0 0 0 0 0
34 0  0  0  0  0  0  0  0  0  0  0  0  0  0  0  0  0  0  32 0  0  0  0  0  0  0  0  0  0  0  0  0  0  0  0  0  0  0  33 0  0  33 30 0 33 0 0 33 0 0 0 0  0 0  0 0 33 0 0 0 0 0 0 0 0 0 0 0 0 0 0 0
30 30 30 0  0  0  0  0  0  0  0  0  0  0  0  0  0  0  35 36 37 0  32 0  0  0  0  0  0  0  0  0  0  0  0  0  0  0  30 30 30 30 30 31 0 34 0 35 34 0 0 0 0 0 33 0 35 34 0 0 0 0 0 0 0 0 0 0 0 0 0 0
31 0  0  0  0  0  0  0  0  0  0  0  0  0  0  30 30 30 35 36 37 35 36 37 0  0  0  0  0  0  0  0  0  30 30 0  0  30 31 31 31 31 31 31 0 34 0 0 34 0 0 33 0 35 34 0 0 34 0 0 0  0  0  0  0  0  0  0  0  0 0 0
31 0  0  0  0  0  0  0  0 0  0  0  0  0  30 31 31 31 35 36 37 35 36 37 0  0  0  0  0  0  0  0  30 31 31 0  0  31 31 31 31 31 31 31 0 34 0 0 34 0 0 34 0 0 34 0 0 34 0 0 0 0  3  0  0  0  0  0  0  0  0 0 0
31 0  0  0  0  0  0  0  0  0  0  0  0  30 31 31 31 31 0  34 3  0  34 0 0  0  0  0  0  33 0  30 31 31 31 0  0  31 31 31 31 31 31 31 0 34 0 0 34 0 0 34 0 0 34 0 0 34 0 0 0 0  33 0  0  0  33 0  0  0  33 0 0 0
31 30 30 30 30 30 30 30 30 30 30 30 30 31 31 31 31 31 30 30 30 30 30 30 30 30 30 30 30 30 30 31 31 31 31 0  0 31 31 31 31 31 31 31 0 34 0 0 34 0 0 34 0 0 34 0 0 34 0 0 0 30 30 30 30 30 30 30 30 30 30 0 0
31 31 31 31 31 31 31 31 31 31 31 31 31 31 31 31 31 31 31 31 31 31 31 31 31 31 31 31 31 31 31 31 31 31 31 0  0 31 31 31 31 31 31 31 0 34 0 0 34 0 0 34 0 0 34 0 0 34 0 0 0 31 31 31 31 31 31 31 31 31 31 0 0
31 31 31 31 31 31 31 31 31 31 31 31 31 31 31 31 31 31 31 31 31 31 31 31 31 31 31 31 31 31 31 31 31 31 31 0  0 31 31 31 31 31 31 31 0 34 0 0 34 0 0 34 0 0 34 0 0 34 0 0 0 31 31 31 31 31 31 31 31 31 31 0 0
31 31 31 31 31 31 31 31 31 31 31 31 31 31 31 31 31 31 31 31 31 31 31 31 31 31 31 31 31 31 31 31 31 31 31 0  0 31 31 31 31 31 31 31 0 34 0 0 34 0 0 34 0 0 34 0 0 34 0 0 0 31 31 31 31 31 31 31 31 31 31 0 0
31 31 31 31 31 31 31 31 31 31 31 31 31 31 31 31 31 31 31 31 31 31 31 31 31 31 31 31 31 31 31 31 31 31 31 0  0 31 31 31 31 31 31 31 0 34 0 0 34 0 0 34 0 0 34 0 0 34 0 0 0 31 31 31 31 31 31 31 31 31 31 0 0
31 31 31 31 31 31 31 31 31 31 31 31 31 31 31 31 31 31 31 31 31 31 31 31 31 31 31 31 31 31 31 31 31 31 31 0  0 31 31 31 31 31 31 31 0 34 0 0 34 0 0 34 0 0 34 0 0 34 0 0 0 31 31 31 31 31 31 31 31 31 31 0 0